 EXTRACTO DE AUDIENCIA EN MATERIA PENAL
Identificación del Proceso: 
Proceso:   No. 09288-2015-01584
Lugar y Fecha de realización: 03 DE MAYO DEL 2016
Hora: 10h36
Presunta Infracción: ART. 379, LESIONES 
Juez: Ab. HERRERA VILLAGRAN EDGAR - JUEZ DE LA UNIDAD PENAL MILAGRO 
Desarrollo de la Audiencia: 
Tipo de audiencia: SUSTITUCION DE LAS MEDIDAS CAUTELARES
Legalidad de la detención:  SI (  )   NO (   )
Audiencia de Formulación de Cargos:  SI  (   )  NO  (    )
Audiencia Preparatoria de Juicio: SI  (     )   NO  (    )
Audiencia de Juicio:  SI  (    )  NO  (   )
Audiencia de Juzgamiento: SI  (    )  NO  (   )
Audiencia de Impugnación:  SI  (   ) NO   (   )
Partes Procesales:
Fiscal: CARLOS CHURTA RODRIGUEZ
CORREO ELECTRONICO: mardoqueocaliz@hotmail.com  
Abogado defensor: AB. JORGE ALBERTO VINUEZA GONZABAY
 CORREO: hugovinuezapuga@hotmail.com
Solicitudes Planteadas por la Defensa:
Existen vicios de procedibilidad:   SI (     )  NO (  x   )
Existen vicios de competencia territorial:   SI (     )  NO (x     )
Existen nulidades procesales:   SI (     )    NO  (    x )
Solicita procedimiento abreviado:   SI   (        )     NO   (    x  )
Solicita acuerdo reparatorio:   SI  (     )     NO   ( x    )
Solicita diferimiento:      SI  (     )      NO   (   x  )
 Una vez constatada la presencia delos sujetos procesales se declara instalada la audiencia concediéndole la palabra al sr.  ab. defensor JORGE ALBERTO VINUEZA GONZABAY: manifestando que al sr. YUQUILEMA GUAMAN RAUL PATRICIO, mi defendido  en la audiencia  de formulación de cargos se ordenó las medidas cautelares del Art. 522 numerales 1 y 2,  que  se presente los días lunes de cada semana en la fiscalía y que no salga del país, que mi defendido ha cumplido su mandato, pero sucede que mi superior,  dentro de la infantería de marina del cantón Machala, no me da el permiso correspondiente, ayer lunes 2 de mayo y firme el acta por cuanto estaba franco, mi petición está basada en que se me revise la medida cautelar,  solicitando  que solamente se me ponga la prohibición de salir del país contemplada en el  Art 522 núm.  1 del COIP. Se corre traslado ala sr. fiscal  CARLOS CHURTA RODRIGUEZ manifestando que  la fiscalía ha podido constatar que se ha emitido  dictamen abstentivo a favor del sr. YUQUILEMA GUAMAN RAUL PATRICIO el mismo que ha sido ratificado por el fiscal provincial,   la fiscalía no tiene ningún impedimento en lo solicitado por la defensa.   El sr. juez  manifiesta que es importante señalar que por principio dispositivo son las partes las que deben introducir las pruebas con las cuales justifiquen sus peticiones que los sujetos procesales, es importante señalar que el sr.  YUQUILEMA GUAMAN RAUL PATRICIO  no ha presentado ningún tipo de certificación que de que efectivamente pertenece a las Fuerzas Armadas de que labora en la infantería de marina de Machala, mas sin embargo por lo mencionando por el sr. fiscal al no tener oposición alguna a la sustitución de la medidas establecidas en el Art. 522 numeral 2,  se deja vigente la establecida en el Art. 522 numeral 1, esto es la  prohibición de salida del país, se girara el correspondiente oficio  ratificando esta medida y se levantara de obligación de presentarse ante el sr. agente fiscal. Quedan oralmente notificados.

RAZÓN: El contenido de la audiencia reposa en archivo de la judicatura. La presente acta queda debidamente suscrita conforme lo dispone la Ley por el señor Secretario de la Unidad Judicial de lo penal   del cantón Milagro, el mismo que da fe de su contenido. Las partes quedan notificadas con las decisiones adoptadas en la audiencia sin perjuicio de lo dispuesto en la Ley respecto a su notificación escrita en las casillas que las partes procesales han señalado para tal efecto.






 Ab. ITALO SANDOVAL MEJIA
Secretario de la  Unidad Judicial Penal con
sede en el Cantón Milagro
     